0,0,0,0,0,0,0,0
5,5,1,2,5,5,1,2
0,0,0,0,0,0,0,0
6,2,5,5,6,2,5,5
0,0,0,0,0,0,0,0
5,5,6,1,5,5,6,1
0,0,0,0,0,0,0,0
1,6,5,5,1,6,5,5
0,0,0,0,0,0,0,0
5,5,2,6,5,5,2,6
0,0,0,0,0,0,0,0
2,1,5,5,2,1,5,5
